x,y,consonne,vowel
1,1,5,1
1,3,3,2
1,4,1,1
1,6,6,1
1,7,2,2
1,9,1,1
1,11,1,1
1,12,9,1
1,14,3,2
1,15,3,1