x,y,consonne,vowel
1,1,5,1
1,3,3,2
1,4,1,1
1,6,6,1
1,7,2,2
1,9,1,1
1,11,1,1
1,12,9,1
1,14,3,2
1,15,3,1
1,17,1,0
1,18,7,4
1,19,0,2
1,20,5,1
1,22,9,0
1,23,3,0
1,24,2,1
1,26,0,1
1,27,6,0
1,29,2,1
1,30,9,1
1,32,5,1
1,33,3,4